111111111111111111111111
10010000100C1110000001C1
10C1000E1000100000000101
1000001110000C1111000101
1110001P10010010CCCCC001
100C00000001100000001111
10CCCCC0000100C000000011
1110011C0100000000110101
1CCCCCC00000101C00011001
111111111111111111111111
