111111111111111111111111
1001000010001110000001C1
10C1000E1000100000000101
100000111000001111000101
1110001P1000001000000001
100C00000000000000001111
10000000000000C000000011
1110011C0100000000110101
1C0000000000001C00011001
111111111111111111111111
