11111111
1E000101
100C1P01
100001C1
1C110001
110000C1
11111111
