111111111111111
1E0CCC11001C0C1
11001111C0001C1
1P00C1C100010C1
1C100CCC0100001
100C110C0C00C11
111111111111111
