111111111111111
1E000E000E00EE1
1P00000000000E1
1000E0000000011
1E0000000000C11
11000E00E000111
111111111111111
