111111111111111
1E0000C11001C01
11001111C000101
1P00C1C10001001
1C1000000100001
100011000C00C11
111111111111111
