111111
1000P1
11001
1EC001
111111
