1111111111111
1B0000PC000E1
1111111111111
