111111111111
100000000001

1PEC00000001
100000000001
111111111111
